WWWWWWWWWWWWW
WWWW00000WWWW
W000XWWW0WWWW
W0W0W0000WWWW
W0W0000WX0WWW
W0W00X00W0WWW
W0XW0000W0WWW
WW0000W0W0WWW
WW0WWWX00000W
WW00000WW000W
WWWWWWWWWWWWW
8,11
4,4
4,6
6,4
6,6
5,5
